---a###c--
---#---#--
---b#e#d#i
-----#---#
-----f###g