---a---c--
---#---#--
---b#e#d--
-----#----
-----f###g